11111111111111111111111111111111111
1000000000000000000000000C0000001E1
1010010101C010101001010100101010101
1P100001010000101000010100000010101
1000000000000000000000000CK00000001
101000010100001C1000010100000010101
101000010100C0101000010100000010101
101000C10100001010000101000000101C1
11111111111111111111111111111111111
